a	a
b	b
c	c
*	ç
d	d
e	e
f	f
g	g
<	ğ
h	h
9	ı
i	i
j	j
k	k
l	l
m	m
n	n
o	o
[	ö
p	p
r	r
s	s
%	ş
t	t
u	u
\	ü
v	v
y	y
z	z
q	q
w	w
x	x