a	aynı
b	büyük
c	can
*	çok
d	daha
e	ekonomi
f	fakat
g	göre
<	eğer
h	her
9	kısa
i	için
j	gün
k	kadar
l	ilgi
m	meydan
n	neden
[	öyle
p	para
r	artık
s	sonra
%	şey
t	taraf
u	uygun
\	dünya
v	var
y	yok
z	zaman
!	bir
5	ve